##########################################################################################
#*************##*************************##*******##**********##*************##**********#
#######*########*##############*###########*##*##*##*#####*##*##*#####*#####*##*##########
#######*########*##############*###########*##*##*##*#####*##*##*#####*#####*##*##########
#*******##*******##****##*******##*******##*##*##*##****##*##*##****##****##****##*******#
#*########*########*##*##*#####*##*#####*##*##*##*########*##*#####*#####*#####*##*#####*#
#*########*########*##*##*#####*##*#####*##*##*##*########*##*#####*#####*#####*##*#####*#
#*##*******##*******##*##****##*##*##*##****##*##**********##****##****##*##****##*##****#
#*##*#################*#####*##*##*##*########*#################*########*##*#####*##*####
#*##*#################*#####*##*##*##*########*#################*########*##*#####*##*####
#****##**********##****##*##*##*##*******##****##*******##****************##*##****##****#
#*########*#####*##*##*##*##*###########*##*#####*#####*##*####################*########*#
#*########*#####*##*##*##*##*###########*##*#####*#####*##*####################*########*#
#**********##*##*##*##****##*##**********##****##*##*##****##****##*************##****##*#
#############*##*##*########*##*##############*##*##*########*##*##*#################*##*#
#############*##*##*########*##*##############*##*##*########*##*##*#################*##*#
#*******##****##*##****##****##*##**********##*##****##****##*##****##*************##*##*#
####*##*##*#####*##*##*##*#####*##*########*##*########*##*##*########*###########*##*##*#
####*##*##*#####*##*##*##*#####*##*########*##*########*##*##*########*###########*##*##*#
#****##*##*##****##*##*##*******##****##*******##*******##****##*##****##*******##****##*#
#*#####*##*##*########*##############*###########*##############*##*##*##*###########*##*#
#*#####*##*##*########*##############*###########*##############*##*##*##*###########*##*#
#****##*##*##**********##****##****##*##**********##*******##****##*##*##*************##*#
#*##*##*##*###########*##*##*##*##*##*##*###########*#####*#####*##*##*########*########*#
#*##*##*##*###########*##*##*##*##*##*##*###########*#####*#####*##*##*########*########*#
#*##*##*##*******##*******##*##*##****##*##**********##*##****##*##*##*******##*******##*#
####*##*#####*#####*###########*########*#####*########*#####*##*##*########*##*########*#
####*##*#####*#####*###########*########*#####*########*#####*##*##*########*##*########*#
#****##****##*##****##*******##*******##****##*##*******##*##*##**********##*##*##*******#
#*########*##*##*#####*#####*##*#####*#####*##*##*#####*##*##*##*###########*#####*#######
#*########*##*##*#####*#####*##*#####*#####*##*##*#####*##*##*##*###########*#####*#######
#****##*******##****##*##*##*##*##****##*##****##*##*******##*##*##**********##****##****#
####*##*###########*##*##*##*#####*##*##*########*###########*##*##*########*##*#####*##*#
####*##*###########*##*##*##*#####*##*##*########*###########*##*##*########*##*#####*##*#
#****##*##**********##*##*##*##****##**********##*************##*##*******##*##****##*##*#
#*########*###########*##*##*##*###########*#####*##############*########*########*##*##*#
#*########*###########*##*##*##*###########*#####*##############*########*########*##*##*#
#*##****##*******##****##*##****##*******##*##****##*##****##****##****##*******##****##*#
#*##*##*##*########*#####*#####*##*#####*#####*#####*##*##*##*#####*##*########*########*#
#*##*##*##*########*#####*#####*##*#####*#####*#####*##*##*##*#####*##*########*########*#
#*##*##****##*******##**********##*##*##*******##*******##****##****##*******##*##*******#
#*##*########*########*###########*##*###########*##############*#####*########*##*#####*#
#*##*########*########*###########*##*###########*##############*#####*########*##*#####*#
#*##****##*##****##****##*******##*******##*******##*************##****##*******##****##*#
#*#####*##*#####*##*#####*#####*########*########*###########*##*########*#####*#####*####
#*#####*##*#####*##*#####*#####*########*########*###########*##*########*#####*#####*####
#*******##****##*##****##*##*##*******##*******##****##****##*##*##*******##****##*##****#
#*###########*##*##*#####*##*#####*##*########*#####*##*##*##*##*##*########*#####*#####*#
#*###########*##*##*#####*##*#####*##*########*#####*##*##*##*##*##*########*#####*#####*#
#*******##****##*##*##****##****##*##*##****##*##*******##*##*##*##*##*************##****#
#######*##*#####*#####*#####*##*##*##*#####*##*###########*##*#####*#################*##*#
#######*##*#####*#####*#####*##*##*##*#####*##*###########*##*#####*#################*##*#
#*******##****##*##**********##*##*##*******##*##****##****##****##*##**********##****##*#
#*###########*##*##*##############*###########*##*##*##*########*##*##*########*##*#####*#
#*###########*##*##*##############*###########*##*##*##*########*##*##*########*##*#####*#
#*******##****##*##*##*************##*******##*##*##*##**********##****##*******##*##****#
#######*##*##*##*##*##*##############*#####*##*##*##*##*#################*########*##*####
#######*##*##*##*##*##*##############*#####*##*##*##*##*#################*########*##*####
#**********##*##****##**********##****##*##*##****##*##*##*******##****##*##*******##****#
#*#############################*##*#####*##*########*##*##*#####*##*##*##*##*###########*#
#*#############################*##*#####*##*########*##*##*#####*##*##*##*##*###########*#
#*##****##*************##*******##****##*##*******##*##*##****##****##*##*##*##*******##*#
####*##*##*###########*##*#####*#####*##*#####*#####*##*#####*########*##*##*##*##*#####*#
####*##*##*###########*##*#####*#####*##*#####*#####*##*#####*########*##*##*##*##*#####*#
#****##*##*##*******##*##*##*******##*##****##****##*##****##*##*##*******##*##*##*******#
#*#####*##*##*#####*##*##*##*########*#####*#####*##*##*#####*##*##*########*##*##########
#*#####*##*##*#####*##*##*##*########*#####*#####*##*##*#####*##*##*########*##*##########
#*##*##*##*##****##****##*##****##****##*******##****##*##****##*##*##*******##****##****#
#*##*##*##*##*########*##*##*#####*#####*#####*###########*#####*##*##*##############*##*#
#*##*##*##*##*########*##*##*#####*#####*#####*###########*#####*##*##*##############*##*#
#*##*******##*##****##****##*##****##*******##*************##*******##****##*******##*##*#
#*##############*##*#####*#####*###########*####################*########*##*#####*##*##*#
#*##############*##*#####*#####*###########*####################*########*##*#####*##*##*#
#*******##*******##*##****##****##**********##****************##*******##****##*##****##*#
#*#####*##*########*##*#####*########*########*##############*########*########*########*#
#*#####*##*########*##*#####*########*########*##############*########*########*########*#
#****##*##****##****##*##****##*******##****##*##****##*******##****##*************##****#
#*#####*##*#####*#####*##*#####*########*##*##*#####*##*########*#################*##*##*#
#*#####*##*#####*#####*##*#####*########*##*##*#####*##*########*#################*##*##*#
#*##****##*##****##****##****##**********##****##****##*##****##*##**********##****##*##*#
####*##*##*##*#####*########*##*#################*#####*##*##*##*##*##*########*#####*####
####*##*##*##*#####*########*##*#################*#####*##*##*##*##*##*########*#####*####
#****##*##*##*##*******##****##*******************##****##*##*##*##*##*************##****#
#*########*##*###########*#####*########*###########*#####*##*##*##*####################*#
#*########*##*###########*#####*########*###########*#####*##*##*##*####################*#
#*******##*##*##**********##****##****##*##**********##****##****##*##****##*##**********#
#*#####*##*##*##*#################*##*#####*###########*##*########*##*##*##*##*##########
#*#####*##*##*##*#################*##*#####*###########*##*########*##*##*##*##*##########
#****##****##**********************##*******##**********##*************##****##**********#
########################################################################################*#
