################################################
#*******##*************##***S***##*************#
#*########*#####*########*#####*##*###########*#
#*########*#####*########*#####*##*###########*#
#*##**********##*************##****##*******##*#
#*##*#################*########*#####*########*#
#*##*#################*########*#####*########*#
#*##*##****##*******##*##****##*******##*******#
#*##*##*#####*#####*#####*##*###########*#######
#*##*##*#####*#####*#####*##############*#######
#*##****##****##*##****##*##*************##****#
#*#####*##*#####*#####*##*##*##*#####*#####*##*#
#*#####*##*#####*#####*##*##*##*#####*#####*##*#
#*##****##*##*******##****##*##*##****##****##*#
#*##*#####*##*#####*###########*#####*##*#####*#
#*##*#####*##*#####*###########*#####*##*#####*#
#*##*##*##*##****##*##*******##****##*##*##****#
#*##*##*##*#####*##*#####*##*#####*#####*##*##*#
#*##*##*##*#####*##*#####*##*#####*#####*##*##*#
#*##****##****##*##*******##****##*******##*##*#
#*#####*#####*##*##############*#####*#####*##*#
#*#####*#####*##*##############*#####*#####*##*#
#****##****##*##*##**********##****##*##****##*#
#*##*#####*##*##*##*##############*#####*#####*#
#*##*#####*##*##*##*##############*#####*#####*#
#*##****##*##****##*##****##*******##****##*##*#
#*##*#####*########*##*##*##*########*#####*##*#
#*##*#####*########*##*##*##*########*#####*##*#
#*##*******##****##****##****##*******##*******#
#*###########*#####*###########*#####*##########
#*###########*#####*###########*#####*##########
#*##**********##****##****##*******##**********#
#*##*##*#####*##*#####*##*#####*##############*#
#*##*##*#####*##*#####*##*#####*##############*#
#*##*##****##*##*##****##****##*##*************#
#*########*#####*##*########*#####*#############
#*########*#####*##*########*#####*#############
#**********##****##*******##*******##****##****#
##########*##*###########*##############*##*##*#
##########*##*###########*##############*##*##*#
#*******##*##*##**********##**********##****##*#
#*#####*##*##*##*###########*########*##*#####*#
#*#####*##*##*##*###########*########*##*#####*#
#****##*##*##****##**********##*##****##*##****#
#*##*#####*###########*########*##*########*##*#
#*##*#####*###########*########*##*########*##*#
#*##***E***************##*******************##*#
################################################
