##########################################################################################
#*******************##****************##****************##*********S******##**********##*#
#*#####*###########*##*########*########*########*##*#####*##*##*###########*#####*##*##*#
#*#####*###########*##*########*########*########*##*#####*##*##*###########*#####*##*##*#
#*##*##*******##*******##****##*##*******##****##*##*##****##*##*##**********##*##*##****#
#*##*########*###########*##*##*##*########*##*##*#####*#####*#####*###########*##*#####*#
#*##*########*###########*##*##*##*########*##*##*#####*#####*#####*###########*##*#####*#
#*##*******##****##****##*##****##*##*******##*##*******##*##****##****##*******##*##****#
#*##*###########*#####*##*########*#####*##*##############*#####*#####*########*##*#######
#*##*###########*#####*##*########*#####*##*##############*#####*#####*########*##*#######
#****##*******##*##****##****##*##****##*##*************##****##*##****##*******##*******#
#*#####*#####*##*##*########*##*#####*###########*##*##*##*##*##*##*#####*##############*#
#*#####*#####*##*##*########*##*#####*###########*##*##*##*##*##*##*#####*##############*#
#*##****##****##*##*******##*******##****##****##*##*##****##*##****##*******##*******##*#
#*##*#####*#####*#####*###########*#####*##*##*#####*########*########*#####*##*#####*##*#
#*##*#####*#####*#####*###########*#####*##*##*#####*########*########*#####*##*#####*##*#
#*##*##****##****##****##*************##*##*##*******##*******##*##*******##*##****##****#
#*##*##*#####*#####*#####*##############*##*###########*########*##*########*#####*#####*#
#*##*##*#####*#####*#####*##############*##*###########*########*##*########*#####*#####*#
#*##*##*##****##****##**********##****##****##****##*##****##*******##****##****##****##*#
#*##*##*##*########*##*###########*##*########*##*##*#####*###########*##*##*##*#####*####
#*##*##*##*########*##*###########*##*########*##*##*#####*###########*##*##*##*#####*####
#*##*##****##*******##*##****##****##**********##*******##*************##*##*##****##****#
#*##*###########*#####*##*##*##*########*##############*#################*##*##*########*#
#*##*###########*#####*##*##*##*########*##############*#################*##*##*########*#
#*##****##*******##****##*##*##*******##*##*##****##****##****##*******##*##*##****##****#
#*#####*#####*#####*#####*##*#####*#####*##*##*##*##*#####*##*##*##*##*##*##*#####*##*##*#
#*#####*#####*#####*#####*##*#####*#####*##*##*##*##*#####*##*##*##*##*##*##*#####*##*##*#
#****##****##*******##****##*******##****##****##*******##*##*##*##*##*##*##*##****##*##*#
##########*##*########*##############*#################*#####*##*##*##*##*##*##*#####*####
##########*##*########*##############*#################*#####*##*##*##*##*##*##*#####*####
#**********##****##****##**********##**********##****##*******##*##*##*##*##*##****##****#
#*###########*#####*#####*########*###########*##*##*###########*##*#####*########*#####*#
#*###########*#####*#####*########*###########*##*##*###########*##*#####*########*#####*#
#****##*##****##****##****##**********##****##****##*##**********##****##*##**********##*#
####*##*##*#####*#####*#####*########*#####*########*##*##############*##*##*#####*#####*#
####*##*##*#####*#####*#####*########*#####*########*##*##############*##*##*#####*#####*#
#****##*******##*##*##****##****##**********##****##****##**********##****##*##*##*##****#
#*##############*##*#####*#####*###########*#####*########*#####*##*########*##*##*##*####
#*##############*##*#####*#####*###########*#####*########*#####*##*########*##*##*##*####
#**********##****##**********##*##*******##****##****##****##****##**********##****##****#
#*########*##*#################*##*#####*#####*##*#####*#####*#################*########*#
#*########*##*#################*##*#####*#####*##*#####*#####*#################*########*#
#*******##*##*##**********##****##****##****##*##**********##**********##*******##****##*#
##########*##*#####*#####*##*#####*########*##*########*##############*##*###########*##*#
##########*##*#####*#####*##*#####*########*##*########*##############*##*###########*##*#
#**********##****##****##*##*******##*******##*******##*##*************##*##**********##*#
#*#####*########*##*##*##*###########*##############*##*##*##############*##*###########*#
#*#####*########*##*##*##*###########*##############*##*##*##############*##*###########*#
#*##****##*******##*##*##*##*******##*##**********##*##*##*##*******##****##**********##*#
#*########*###########*##*##*#####*##*##*##*########*##*##*##*##*#####*##############*##*#
#*########*###########*##*##*#####*##*##*##*########*##*##*##*##*#####*##############*##*#
#*##*******##*******##*##****##*******##*##*##*******##*##*##*##****##*##****##****##*##*#
#*##*########*#####*##*#################*##*##*########*##*#####*##*##*##*##*##*##*##*##*#
#*##*########*#####*##*#################*##*##*########*##*#####*##*##*##*##*##*##*##*##*#
#*##**********##****##****##****##*******##*##****##****##****##*##****##*##****##*##*##*#
#*##############*#####*##*##*##*##*########*#####*###########*##*########*########*##*##*#
#*##############*#####*##*##*##*##*########*#####*###########*##*########*########*##*##*#
#*##****##****##****##*##****##*##****##****##****##**********##**********##****##****##*#
#*##*##*##*##*#####*##*########*#####*##*#####*#####*########*##############*##*##*#####*#
#*##*##*##*##*#####*##*########*#####*##*#####*#####*########*##############*##*##*#####*#
#****##*##*##*******##*******##****##*##****##****##*##*******##****##*##****##*##*##****#
#*#####*##*#######################*##*#####*#####*##*##*########*##*##*##*##*#####*##*##*#
#*#####*##*#######################*##*#####*#####*##*##*########*##*##*##*##*#####*##*##*#
#****##*##*******##****************##*##*##****##*##*##****##****##*##****##*******##*##*#
#*#####*########*##*#################*##*#####*##*##*########*#####*#####*###########*##*#
#*#####*########*##*#################*##*#####*##*##*########*#####*#####*###########*##*#
#*##****##*******##*##*******##****##****##*##*##****##*******##*##****##**********##*##*#
####*##*##*########*##*#####*##*########*##*##*#####*##*########*#####*##############*##*#
####*##*##*########*##*#####*##*########*##*##*#####*##*########*#####*##############*##*#
#****##*##*******##*##****##****##*******##*##*******##*##****##*##****##*************##*#
#*#####*########*##*#####*########*########*###########*##*##*##*##*#####*##############*#
#*#####*########*##*#####*########*########*###########*##*##*##*########*##############*#
#*##**********##****##****##*******##**********##****##*##*##*******##*##****##****##****#
#*####################*##*##*##############*##*##*#####*##*########*##*##*##*##*##*##*####
#*####################*##*##*##############*##*##*#####*##*########*##*##*##*##*##*##*####
#*##*******************##*##****************##****##****##*##*##****##****##*##*##*##****#
#*##*#################*##*#######################*##*#####*##*##*#####*#####*##*##*#####*#
#*##*#################*##*#######################*##*#####*##*##*#####*#####*##*##*#####*#
#*##****##**********##*##****##****************##*##*******##*##****##*##****##*##*##****#
#*#####*########*#####*########*###########*#####*###########*#####*##*##*#####*##*##*####
#*#####*########*#####*########*###########*#####*###########*#####*##*##*#####*##*##*####
#****##*##****##****##*##*******##**********##****##****##****##*##*##*##*##****##*##*##*#
#*##*##*##*##*#####*##*##*########*###########*#####*##*##*##*##*##*#####*##*#####*##*##*#
#*##*##*##*##*#####*##*##*########*###########*#####*##*##*##*##*##*#####*##*#####*##*##*#
#*##*##*##*##*******##*##*******##*##*******##*##****##****##****##*##****##*##****##*##*#
#*##*##*##*########*##*########*##*##*#####*##*##*##############*##*##*#####*##*#####*##*#
#*##*##*##*########*##*########*##*##*#####*##*##*##############*##*##*#####*##*#####*##*#
#*##*******##*******##**********##*******##*******##*************##***E##****##**********#
##########################################################################################
