########################
#**********##S*********#
#######*#####*##*#####*#
#######*#####*##*#####*#
#****##*******##*##*##*#
#*##*###########*##*##*#
#*##*###########*##*##*#
#*##*************##****#
#*##*##############*####
#*##*##############*####
#*##*##****##****##****#
#*#####*##*##*##*#######
#*#####*##*##*##*#######
#****##*##****##*******#
#*##*##*##############*#
#*##*##*##############*#
#*##*##**********##****#
#*##*#####*########*####
#*##*#####*########*####
#*##****##*##****##****#
#*##*#####*##*##*#####*#
#*##*#####*#####*#####*#
#*##**********##***E***#
########################
