##########################################################################################
#*##**********************##*************************##**********##****************##%*#*#
#*##*##############*##*#####*###########*##*###########*#####*##*##*########*#####*##*##*#
#*##*##############*##*#####*###########*##*###########*#####*##*##*########*#####*##*##*#
#*******##**********##*##****##**********##*##*******##*##****##*##*##*******##****##*##*#
##########*###########*##*#####*##############*#####*##*##*#####*#####*###########*##*##*#
##########*###########*##*#####*##############*#####*##*##*#####*#####*###########*##*##*#
#**********##*******##*##*##*##****************##****##*##*##**********##*******##*##****#
#*###########*#####*##*##*##*####################*#####*##*##############*#####*##*#####*#
#*###########*#####*##*##*##*####################*#####*##*##############*#####*##*#####*#
#****##****##****##*##*##*******##**********##****##****##*************##*##*##*##****##*#
#*##*##*##*##*##*#####*#####*#####*########*##*##*##*#################*##*##*##*########*#
#*##*##*##*##*##*#####*#####*#####*########*##*##*##*#################*##*##*##*########*#
#*##*##*##****##****##****##*##****##****##*##*##*##*##**********##*##*##*##*##**********#
####*##*###########*##*#####*##*#####*#####*##*##*##*##*########*##*##*##*##*#############
####*##*###########*##*#####*##*#####*#####*##*##*##*##*########*##*##*##*##*#############
#****##*##*******##****##****##*##*************##*##****##****##****##****##*************#
#*#####*##*##############*#####*##########################*##*#####*###########*#####*##*#
#*#####*##*##############*#####*##########################*##*#####*###########*#####*##*#
#*##*******##**********##****##*##****##****##*******##****##****##*##*******##****##*##*#
#*###########*########*#####*##*##*##*##*##*##*##*##*##*########*##*##*#####*########*##*#
#*###########*########*#####*##*##*##*##*##*##*##*##*##*########*##*##*#####*########*##*#
#****##****##****##*******##*##****##****##*##*##*##****##*******##*##****##*##****##*##*#
####*##*##*#####*##*########*##############*##*##*##*########*#####*#####*##*##*##*##*##*#
####*##*##*#####*##*########*##############*##*##*##*########*#####*#####*##*##*##*##*##*#
#****##*##*##****##**********##****##****##****##*##*##****##****##*##****##****##*##*##*#
#*#####*##*##*#################*#####*##*########*#####*##*########*##*###########*##*##*#
#*#####*##*##*#################*#####*##*########*#####*##*########*##*###########*##*##*#
#*##****##****##**********##**********##*******##*******##****##****##*##****##****##*##*#
#*##*###########*########*##############*##*#################*##*#####*##*#####*#####*##*#
#*##*###########*########*##############*##*#################*##*#####*##*#####*#####*##*#
#*##*##**********##****##*******##****##*##****************##*##****##*##*******##****##*#
#*##*##*##*##*#####*##*########*##*##*########*###########*##*#####*##*##*########*#####*#
#*##*##*##*##*#####*##*########*##*##*########*###########*##*#####*##*##*########*#####*#
#****##*##*##*##****##*##****##****##*******##*##**********##****##****##**********##*##*#
#*#####*##*#####*#####*#####*##############*##*##*########*##*#######################*##*#
#*#####*##*#####*#####*#####*##############*##*##*########*##*#######################*##*#
#****##*##*##****##*##*##****************##*##*##*##****##*##**********##****##**********#
####*#####*##*#####*##*##*#################*##*#####*##*##*#####*########*##*##*##########
####*#####*##*#####*##*##*#################*##*#####*##*##*#####*########*##*##*##########
#*##****##*##*##****##*##****************##*##*******##*##****##*##****##*##****##*******#
#*#####*##*##*##*#####*##*##############*##*###########*#####*##*##*##*##*########*#####*#
#*#####*##*##*##*#####*##*##############*##*###########*#####*##*##*##*##*########*#####*#
#*******##****##*##****##****##*******##*##****##*******##****##****##****##*******##****#
#*########*#####*##*########*########*##*#####*##*########*#################*########*####
#*########*#####*##*########*########*##*#####*##*########*#################*########*####
#****##*##*******##****##**********##*##****##****##****##****##****##*******##*##*******#
####*##*########*#####*###########*##*#####*########*##*#####*##*#####*##*#####*##*#######
####*##*########*#####*###########*##*#####*########*##*#####*##*#####*##*#####*##*#######
#****##**********##*##*******##*##****##**********##*##*******##*******##****##****##****#
#*##############*##*########*##*##*#####*########*##*###########*###########*########*##*#
#*##############*##*########*##*##*#####*########*##*###########*###########*########*##*#
#*************##*##*******##*##*##*##****##*******##*##*******##**********##****##****##*#
#############*##*#####*#####*##*##*##*##############*##*#####*#####*###########*##*#####*#
#############*##*#####*#####*##*##*##*##############*##*#####*#####*###########*##*#####*#
#*******##****##*******##****##****##****##*******##*##****##*******##**********##*##*##*#
#*#####*##*##############*##############*##*#####*##*#####*###########*###########*##*##*#
#*#####*##*##############*##############*##*#####*##*#####*###########*###########*##*##*#
#****##*##****##**********##**********##*##*##*##****##*##*##*******##****************##*#
####*##*#####*##*###########*########*##*##*##*########*##*#####*#######################*#
####*##*#####*##*###########*########*##*##*##*########*##*#####*#######################*#
#****##****##****##**********##*******##*##*##*******##****##****##****##****##**********#
#######*##*########*##*########*########*##*##*#####*##*#####*##*##*##*##*##*##*########*#
#######*##*########*##*########*########*##*##*#####*##*#####*##*##*##*##*##*##*########*#
#*******##*##****##*##*##*******##*******##*##*##****##*******##*##*##****##****##*##****#
#*###########*##*##*##*##*########*#####*##*##*##*##############*##*##############*##*####
#*###########*##*##*##*##*########*#####*##*##*##*##############*##*##############*##*####
#*************##****##*##**********##*##*##****##*##**********##*##*##****##*******##****#
#######*##############*##############*##*########*##*########*##*##*##*##*##*###########*#
#######*##############*##############*##*########*##*########*##*##*##*##*##*###########*#
#****##*##*************##*******##*************##*##*******##*##*##****##*##*******##****#
#*##*#####*#####*########*#####*##*##############*########*##*##*########*########*##*####
#*##*#####*#####*########*#####*##*##############*########*##*##*########*########*##*####
#*##*******##****##*******##****##*##*************##****##*##****##****##****##****##****#
#*###########*#####*########*#####*##*#################*##*########*##*#####*##*########*#
#*###########*#####*########*#####*##*#################*##*########*##*#####*##*########*#
#**********##****##*##****##*##*##*##****##**********##*##*##*******##*##****##**********#
#*########*########*#####*##*##*##*#####*##*########*##*##*##*########*##*##############*#
#*########*########*#####*##*##*##*#####*##*########*##*##*##*########*##*##############*#
#*##****##**********##****##*##*******##*##****##****##*******##****##*##*************##*#
#*##*#################*#####*##*########*##*##*##*#####*########*##*#################*####
#*##*#################*#####*##*########*##*##*##*#####*########*##*#################*####
#*##****************##*##****##*##*******##*##*##*##****##*******##*******##*******##****#
#*##############*##*##*##*########*###########*##*##*#####*##############*##*#####*##*##*#
#*##############*##*##*##*########*###########*##*##*#####*##############*##*#####*##*##*#
#****##**********##*##*##*******##****##*******##*##*##****##****##****##****##*##*##*##*#
####*##*###########*##*########*#####*##*########*#####*#####*#####*##*########*##*#####*#
####*##*###########*##*########*#####*##*########*#####*#####*#####*##*########*##*#####*#
#*******##*******************##**********##*************##**********##*******************#
##########################################################################################
